1212121211
--1-------
----------
-----1---
-----2----
----------
-------4--
--3-------
----------
-3--------
----------
---4------
