--c----c--
---1------
----------
--------2-
----------
---------1
----------
--2-------
--4-------
----------
-----3----
----------
---4------
